"filename", "language", "Ini", "C++", "CSV", "cmake", "Markdown", "comment", "blank", "total"
"c:\Users\pjahelka\Documents\PlatformIO\Projects\ESP32_Radio_Rebuild\CMakeLists.txt", "cmake", 0, 0, 0, 3, 0, 0, 1, 4
"c:\Users\pjahelka\Documents\PlatformIO\Projects\ESP32_Radio_Rebuild\README.md", "Markdown", 0, 0, 0, 0, 1, 0, 1, 2
"c:\Users\pjahelka\Documents\PlatformIO\Projects\ESP32_Radio_Rebuild\lib\A2DP_mode\A2DP_mode.cpp", "C++", 0, 39, 0, 0, 0, 5, 5, 49
"c:\Users\pjahelka\Documents\PlatformIO\Projects\ESP32_Radio_Rebuild\lib\A2DP_mode\A2DP_mode.h", "C++", 0, 7, 0, 0, 0, 0, 2, 9
"c:\Users\pjahelka\Documents\PlatformIO\Projects\ESP32_Radio_Rebuild\lib\conf_mode\conf_mode.cpp", "C++", 0, 120, 0, 0, 0, 18, 23, 161
"c:\Users\pjahelka\Documents\PlatformIO\Projects\ESP32_Radio_Rebuild\lib\conf_mode\conf_mode.h", "C++", 0, 4, 0, 0, 0, 0, 1, 5
"c:\Users\pjahelka\Documents\PlatformIO\Projects\ESP32_Radio_Rebuild\lib\menu_mode\menu_mode.cpp", "C++", 0, 71, 0, 0, 0, 5, 3, 79
"c:\Users\pjahelka\Documents\PlatformIO\Projects\ESP32_Radio_Rebuild\lib\menu_mode\menu_mode.h", "C++", 0, 9, 0, 0, 0, 0, 2, 11
"c:\Users\pjahelka\Documents\PlatformIO\Projects\ESP32_Radio_Rebuild\lib\radio_config\radio_config.cpp", "C++", 0, 14, 0, 0, 0, 0, 2, 16
"c:\Users\pjahelka\Documents\PlatformIO\Projects\ESP32_Radio_Rebuild\lib\radio_config\radio_config.h", "C++", 0, 34, 0, 0, 0, 15, 13, 62
"c:\Users\pjahelka\Documents\PlatformIO\Projects\ESP32_Radio_Rebuild\lib\wifi_mode\wifi_mode.cpp", "C++", 0, 126, 0, 0, 0, 12, 12, 150
"c:\Users\pjahelka\Documents\PlatformIO\Projects\ESP32_Radio_Rebuild\lib\wifi_mode\wifi_mode.h", "C++", 0, 21, 0, 0, 0, 3, 2, 26
"c:\Users\pjahelka\Documents\PlatformIO\Projects\ESP32_Radio_Rebuild\platformio.ini", "Ini", 18, 0, 0, 0, 0, 9, 2, 29
"c:\Users\pjahelka\Documents\PlatformIO\Projects\ESP32_Radio_Rebuild\radio_partitions.csv", "CSV", 0, 0, 4, 0, 0, 0, 0, 4
"c:\Users\pjahelka\Documents\PlatformIO\Projects\ESP32_Radio_Rebuild\src\CMakeLists.txt", "cmake", 0, 0, 0, 2, 0, 2, 3, 7
"c:\Users\pjahelka\Documents\PlatformIO\Projects\ESP32_Radio_Rebuild\src\main.cpp", "C++", 0, 100, 0, 0, 0, 22, 5, 127
"Total", "-", 18, 545, 4, 5, 1, 91, 77, 741